NO ./textures/mur/nprth.xpm
SO ./textures/mur/south.xpm
WE ./textures/mur/west.xpm
EA ./textures/mur/east.xpm
F 220,100,0
C 225,30,0

1111111111
1000000001
1000N00001
10001010111
1111111111
