NO ./textures/mur/north.xpm
SO ./textures/mur/south.xpm
WE ./textures/mur/west.xpm
EA ./textures/mur/east.xpm

F 150,150,150
C 199,207,225
111111111         11111111111
100000001         10000000001
10110000111111111110000010001
10010000000000000000000010001
10110000011100000000000011111
1000000000110000011101111
1111011111111101110000001
1111011111111101110101001
1100000011010101110000001
1000000000000000110000001
10000000000000001101010011111
11000000110101000000000000001
11110111110101000000101000001
10000000001100000100000010001
10000000000000001000100001001
10000000001000010000000001001
10000000001101000000N00000001
10000000000100000001010000001
11111111111111111111111111111