NO ./textures/mur/north.xpm
SO ./textures/mur/south.xpm
WE ./textures/mur/west.xpm
EA ./textures/mur/east.xpm

F 107,142,35
C 135,206,235

1111111111
1000001001
1000N10001
1000101111
1111111111