NO ./textures/mur/nprth.xpm
SO ./textures/mur/south.xpm
WE ./textures/mur/west.xpm
EA ./textures/mur/east.xpm

F 116,113,118
C 90,125,148

1111111111
1000001001
1000N10001
1000101111
1111111111