NO ./textures/mur/north.xpm
SO ./textures/mur/south.xpm
WE ./textures/mur/west.xpm
EA ./textures/mur/east.xpm
F 100,50,25
C 0,100,200

1111111111111111
1000100000100001
1010101110101101
1000000000000001
1111101111110111
1000000000010001
1011111011110101
1000001000000001
1110101111111101
1000100000000001
1011101111101111
1000000000100001
1111111011101111
100000000000000S1
1111111111111111