NO ./textures/mur/north.xpm
SO ./textures/mur/south.xpm
WE ./textures/mur/west.xpm
EA ./textures/mur/east.xpm
F 256,100,0
C 225,30,0

1111111
100N001
1111111