SO ./textures/mur/south.xpm
WE ./textures/mur/west.xpm
EA ./textures/mur/east.xpm
F 220,100,0
C 225,30,0

1111111
1000001
10XN001
1000001
1111111